4.0
16.0
-1.57

#############################
#                 #         #
#      ############         ############################
#      #          #  					#
#                 #					#
#      #          #					#
#      #          #					#
#      #          ######################################
###############  #				       #
#                 #         ###########################
#				  #		       #
#                 #			#	       #
#                 #####	#		       #
#                 			#	       #
#                 #			#	       #
#                 #			#	       #
########################################################
